1111111111
1P11000101
1010010101
1C00110101
1C10111101
1010001001
1011111011
1E00000011
1111111111