1111111111
1P110001E1
1010010101
100011C101
1010111101
10100C1001
1011111011
1000000011
1111111111